# resolution=4
# cols=112
# rows=144
1222222222222222222222222222222222222222222222222222222222222222222222222222222222222222222222222222222222222221
3000000000000000000000000000000000000000000000000000000000000000000000000000000000000000000000000000000000000003
3000000000000000000000000000000000000000000000000000000000000000000000000000000000000000000000000000000000000003
3000000000000000000000000000000000000000000000000000000000000000000000000000000000000000000000000000000000000003
3000000000000000000000000000000000000000000000000000000000000000000000000000000000000000000000000000000000000003
3000000000000000000000000000000000000000000000000000000000000000000000000000000000000000000000000000000000000003
3000000000000000000000000000000000000000000000000000000000000000000000000000000000000000000000000000000000000003
3000000000000000000000000000000000000000000000000000000000000000000000000000000000000000000000000000000000000003
3000000000000000000000000000000000000000000000000000000000000000000000000000000000000000000000000000000000000003
3000000000000000000000000000000000000000000000000000000000000000000000000000000000000000000000000000000000000003
3000000000000000000000000000000000000000000000000000000000000000000000000000000000000000000000000000000000000003
3000000000000000000000000000000000000000000000000000000000000000000000000000000000000000000000000000000000000003
3000000000000000000000000000000000000000000000000000000000000000000000000000000000000000000000000000000000000003
3000000000000000000000000000000000000000000000000000000000000000000000000000000000000000000000000000000000000003
3000000000000000000000000000000000000000000000000000000000000000000000000000000000000000000000000000000000000003
1222222222222222222222222222100000012222222222222222222222222222222222222222100000012222222222222222222222222221
0000000000000000000000000000300000030000000000000000000000000000000000000000300000030000000000000000000000000000
0000000000000000000000000000300000030000000000000000000000000000000000000000300000030000000000000000000000000000
0000000000000000000000000000300000030000000000000000000000000000000000000000300000030000000000000000000000000000
0000000000000000000000000000300000030000000000000000000000000000000000000000300000030000000000000000000000000000
1222222222222222222222210000300000030000122222222222222222222222222222210000300000030000122222222222222222222221
3000000000000000000000030000300000030000300000000000000000000000000000030000300000030000300000000000000000000003
3000000000000000000000030000300000030000300000000000000000000000000000030000300000030000300000000000000000000003
3000000000000000000000030000300000030000300000000000000000000000000000030000300000030000300000000000000000000003
3000000000000000000000030000300000030000300000000000000000000000000000030000300000030000300000000000000000000003
3000000000000000000000030000300000030000300000000000000000000000000000030000300000030000300000000000000000000003
3000000000000000000000030000300000030000300000000000000000000000000000030000300000030000300000000000000000000003
3001222222222222222222210000122222210000122222222222100000012222222222210000122222210000122222222222222222221003
3003000000000000000000000000000000000000000000000000300000030000000000000000000000000000000000000000000000003003
3003000000000000000000000000000000000000000000000000300000030000000000000000000000000000000000000000000000003003
3003000000000000000000000000000000000000000000000000300000030000000000000000000000000000000000000000000000003003
3003000000000000000000000000000000000000000000000000300000030000000000000000000000000000000000000000000000003003
3003000012222222222222222222222222210000122222210000300000030000122222210000122222222222222222222222222100003003
3003000030000000000000000000000000030000300000030000300000030000300000030000300000000000000000000000000300003003
3003000030000000000000000000000000030000300000030000300000030000300000030000300000000000000000000000000300003003
3003000030000000000000000000000000030000300000030000300000030000300000030000300000000000000000000000000300003003
3003000030000000000000000000000000030000300000030000300000030000300000030000300000000000000000000000000300003003
3003000030000000000000000000000000030000300000030000300000030000300000030000300000000000000000000000000300003003
3003000030000000000000000000000000030000300000030000300000030000300000030000300000000000000000000000000300003003
3003000030000001222222222222222222210000300000030000300000030000300000030000122222222222222222221000000300003003
3003000030000003000000000000000000000000300000030000300000030000300000030000000000000000000000003000000300003003
3003000030000003000000000000000000000000300000030000300000030000300000030000000000000000000000003000000300003003
3003000030000003000000000000000000000000300000030000300000030000300000030000000000000000000000003000000300003003
3003000030000003000000000000000000000000300000030000122222210000300000030000000000000000000000003000000300003003
3003000030000003000012222222222222210000300000030000000000000000300000030000122222222222222100003000000300003003
3003000030000003000030000000000000030000300000030000000000000000300000030000300000000000000300003000000300003003
3003000030000003000030000000000000030000300000030000000000000000300000030000300000000000000300003000000300003003
3003000030000003000030000000000000030000300000030000000000000000300000030000300000000000000300003000000300003003
3003000030000003000030000000000000030000300000012222222222222222100000030000300000000000000300003000000300003003
3003000030000003000030000000000000030000300000000000000000000000000000030000300000000000000300003000000300003003
3003000030000003000030000000000000030000300000000000000000000000000000030000300000000000000300003000000300003003
3003000012222221000012222222100000030000300000000000000000000000000000030000300000012222222100001222222100003003
3003000000000000000000000000300000030000300000000000000000000000000000030000300000030000000000000000000000003003
3003000000000000000000000000300000030000300000000000000000000000000000030000300000030000000000000000000000003003
3003000000000000000000000000300000030000300000000000000000000000000000030000300000030000000000000000000000003003
3003000000000000000000000000300000030000122222222222222222222222222222210000300000030000000000000000000000003003
3001222222222222222222210000300000030000000000000000000000000000000000000000300000030000122222222222222222221003
3000000000000000000000030000300000030000000000000000000000000000000000000000300000030000300000000000000000000003
3000000000000000000000030000300000030000000000000000000000000000000000000000300000030000300000000000000000000003
3000000000000000000000030000300000030000000000000000000000000000000000000000300000030000300000000000000000000003
3000000000000000000000030000300000030000122222222221000000001222222222210000300000030000300000000000000000000003
3000000000000000000000030000300000030000300000000003000000003000000000030000300000030000300000000000000000000003
3000000000000000000000030000300000030000300000000003000000003000000000030000300000030000300000000000000000000003
3001222222222222222222210000300000030000300122222221000000001222222210030000300000030000122222222222222222221003
3003000000000000000000000000300000030000300300000000000000000000000030030000300000030000000000000000000000003003
3003000000000000000000000000300000030000300300000000000000000000000030030000300000030000000000000000000000003003
3003000000000000000000000000300000030000300300000000000000000000000030030000300000030000000000000000000000003003
3003000000000000000000000000300000030000300300000000000000000000000030030000300000030000000000000000000000003003
3003000012222222222222210000300000030000300300000000000000000000000030030000300000030000122222222222222100003003
3003000030000000000000030000300000030000300300000000000000000000000030030000300000030000300000000000000300003003
3003000030000000000000030000300000030000300300000000000000000000000030030000300000030000300000000000000300003003
3003000030000000000000030000122222210000300300000000000000000000000030030000122222210000300000000000000300003003
3003000030000000000000030000000000000000300300000000000000000000000030030000000000000000300000000000000300003003
3003000030000000000000030000000000000000300300000000000000000000000030030000000000000000300000000000000300003003
3003000030000000000000030000000000000000300300000000000000000000000030030000000000000000300000000000000300003003
3003000012222222100000030000000000000000300300000000000000000000000030030000000000000000300000012222222100003003
3003000000000000300000030000122222210000300122222222222222222222222210030000122222210000300000030000000000003003
3003000000000000300000030000300000030000300000000000000000000000000000030000300000030000300000030000000000003003
3003000000000000300000030000300000030000300000000000000000000000000000030000300000030000300000030000000000003003
3003000000000000300000030000300000030000122222222222222222222222222222210000300000030000300000030000000000003003
3001222222210000300000030000300000030000000000000000000000000000000000000000300000030000300000030000122222221003
3000000000030000300000030000300000030000000000000000000000000000000000000000300000030000300000030000300000000003
3000000000030000300000030000300000030000000000000000000000000000000000000000300000030000300000030000300000000003
1222222210030000300000030000300000030000000000000000000000000000000000000000300000030000300000030000300122222221
0000000030030000300000030000300000012222222100001222222222222221000012222222100000030000300000030000300300000000
0000000030030000300000030000300000000000000300003000000000000003000030000000000000030000300000030000300300000000
0000000030030000300000030000300000000000000300003000000000000003000030000000000000030000300000030000300300000000
0000000030030000300000030000300000000000000300003000000000000003000030000000000000030000300000030000300300000000
0000000030030000300000030000300000000000000300003000000000000003000030000000000000030000300000030000300300000000
0000000030030000300000030000300000000000000300003000000000000003000030000000000000030000300000030000300300000000
0000000030030000300000030000300000000000000300003000000000000003000030000000000000030000300000030000300300000000
0000000030030000122222210000122222222222222100003000000000000003000012222222222222210000122222210000300300000000
0000000030030000000000000000000000000000000000003000000000000003000000000000000000000000000000000000300300000000
0000000030030000000000000000000000000000000000003000000000000003000000000000000000000000000000000000300300000000
0000000030030000000000000000000000000000000000003000000000000003000000000000000000000000000000000000300300000000
0000000030030000000000000000000000000000000000003000000000000003000000000000000000000000000000000000300300000000
0000000030030000122222222222222222222222222100003000000000000003000012222222222222222222222222210000300300000000
0000000030030000300000000000000000000000000300003000000000000003000030000000000000000000000000030000300300000000
0000000030030000300000000000000000000000000300003000000000000003000030000000000000000000000000030000300300000000
0000000030030000300000000000000000000000000300003000000000000003000030000000000000000000000000030000300300000000
1222222210030000300000000000000000000000000300003000000000000003000030000000000000000000000000030000300122222221
3000000000030000300000000000000000000000000300003000000000000003000030000000000000000000000000030000300000000003
3000000000030000300000000000000000000000000300003000000000000003000030000000000000000000000000030000300000000003
1222222222210000122222222222100000012222222100001222222222222221000012222222100000012222222222210000122222222221
0000000000000000000000000000300000030000000000000000000000000000000000000000300000030000000000000000000000000000
0000000000000000000000000000300000030000000000000000000000000000000000000000300000030000000000000000000000000000
0000000000000000000000000000300000030000000000000000000000000000000000000000300000030000000000000000000000000000
0000000000000000000000000000300000030000000000000000000000000000000000000000300000030000000000000000000000000000
1222222222210000122222210000300000030000122222222222222222222222222222210000300000030000122222210000122222222221
3000000000030000300000030000300000030000300000000000000000000000000000030000300000030000300000030000300000000003
3000000000030000300000030000300000030000300000000000000000000000000000030000300000030000300000030000300000000003
3000000000030000300000030000300000030000300000000000000000000000000000030000300000030000300000030000300000000003
3000000000030000300000030000300000030000300000000000000000000000000000030000300000030000300000030000300000000003
3000000000030000300000030000300000030000300000000000000000000000000000030000300000030000300000030000300000000003
3000000000030000300000030000300000030000300000000000000000000000000000030000300000030000300000030000300000000003
3001222222210000300000030000122222210000122222222222100000012222222222210000122222210000300000030000122222221003
3003000000000000300000030000000000000000000000000000300000030000000000000000000000000000300000030000000000003003
3003000000000000300000030000000000000000000000000000300000030000000000000000000000000000300000030000000000003003
3003000000000000300000030000000000000000000000000000300000030000000000000000000000000000300000030000000000003003
3003000000000000300000030000000000000000000000000000300000030000000000000000000000000000300000030000000000003003
3003000012222222100000030000122222222222222222210000300000030000122222222222222222210000300000012222222100003003
3003000030000000000000030000300000000000000000030000300000030000300000000000000000030000300000000000000300003003
3003000030000000000000030000300000000000000000030000300000030000300000000000000000030000300000000000000300003003
3003000030000000000000030000300000000000000000030000300000030000300000000000000000030000300000000000000300003003
3003000030000000000000030000300000000000000000030000300000030000300000000000000000030000300000000000000300003003
3003000030000000000000030000300000000000000000030000300000030000300000000000000000030000300000000000000300003003
3003000030000000000000030000300000000000000000030000300000030000300000000000000000030000300000000000000300003003
3003000012222222222222210000122222222222222222210000122222210000122222222222222222210000122222222222222100003003
3003000000000000000000000000000000000000000000000000000000000000000000000000000000000000000000000000000000003003
3003000000000000000000000000000000000000000000000000000000000000000000000000000000000000000000000000000000003003
3003000000000000000000000000000000000000000000000000000000000000000000000000000000000000000000000000000000003003
3003000000000000000000000000000000000000000000000000000000000000000000000000000000000000000000000000000000003003
3001222222222222222222222222222222222222222222222222222222222222222222222222222222222222222222222222222222221003
3000000000000000000000000000000000000000000000000000000000000000000000000000000000000000000000000000000000000003
3000000000000000000000000000000000000000000000000000000000000000000000000000000000000000000000000000000000000003
3000000000000000000000000000000000000000000000000000000000000000000000000000000000000000000000000000000000000003
3000000000000000000000000000000000000000000000000000000000000000000000000000000000000000000000000000000000000003
3000000000000000000000000000000000000000000000000000000000000000000000000000000000000000000000000000000000000003
3000000000000000000000000000000000000000000000000000000000000000000000000000000000000000000000000000000000000003
3000000000000000000000000000000000000000000000000000000000000000000000000000000000000000000000000000000000000003
3000000000000000000000000000000000000000000000000000000000000000000000000000000000000000000000000000000000000003
3000000000000000000000000000000000000000000000000000000000000000000000000000000000000000000000000000000000000003
3000000000000000000000000000000000000000000000000000000000000000000000000000000000000000000000000000000000000003
1222222222222222222222222222222222222222222222222222222222222222222222222222222222222222222222222222222222222221
