 0, 0, 0, 0, 0, 0, 0, 0, 0, 0, 0, 0, 0, 0, 0, 0, 0, 0, 0, 0, 0, 0, 0, 0, 0, 0, 0, 0
 0, 0, 0, 0, 0, 0, 0, 0, 0, 0, 0, 0, 0, 0, 0, 0, 0, 0, 0, 0, 0, 0, 0, 0, 0, 0, 0, 0
 0, 0, 0, 0, 0, 0, 0, 0, 0, 0, 0, 0, 0, 0, 0, 0, 0, 0, 0, 0, 0, 0, 0, 0, 0, 0, 0, 0
10, 8, 8, 8, 8, 8, 8, 8, 8, 8,11,10, 8, 8, 8, 8,11,10, 8, 8, 8, 8, 8, 8, 8, 8, 8,11
 9, 0, 0, 0, 0, 0, 0, 0, 0, 0, 9, 9, 0, 0, 0, 0, 9, 9, 0, 0, 0, 0, 0, 0, 0, 0, 0, 9
 9, 0, 3, 1, 1, 1, 1, 1, 4, 0, 9, 9, 0, 3, 4, 0, 9, 9, 0, 3, 1, 1, 1, 1, 1, 4, 0, 9
 9, 0, 2, 3, 1, 1, 1, 1, 5, 0,13,12, 0, 2, 2, 0,13,12, 0, 6, 1, 1, 1, 1, 4, 2, 0, 9
 9, 0, 2, 2, 0, 0, 0, 0, 0, 0, 0, 0, 0, 2, 2, 0, 0, 0, 0, 0, 0, 0, 0, 0, 2, 2, 0, 9
 9, 0, 6, 5, 0, 3, 4, 0, 3, 1, 1, 4, 0, 2, 2, 0, 3, 1, 1, 4, 0, 3, 4, 0, 6, 5, 0, 9
 9, 0, 0, 0, 0, 2, 2, 0, 2, 0, 0, 2, 0, 2, 2, 0, 2, 0, 0, 2, 0, 2, 2, 0, 0, 0, 0, 9
13, 8, 8,11, 0, 2, 2, 0, 6, 1, 1, 5, 0, 6, 5, 0, 6, 1, 1, 5, 0, 2, 2, 0,10, 8, 8,12
 8, 8, 8,12, 0, 2, 2, 0, 0, 0, 0, 0, 0, 0, 0, 0, 0, 0, 0, 0, 0, 2, 2, 0,13, 8, 8, 8
 7, 0, 0, 0, 0, 2, 6, 1, 4, 0, 3, 1, 1, 1, 1, 1, 1, 4, 0, 3, 1, 5, 2, 0, 0, 0, 0, 7
11, 0, 3, 4, 0, 6, 1, 1, 5, 0, 6, 1, 1, 1, 1, 1, 1, 5, 0, 6, 1, 1, 5, 0, 3, 4, 0,10
 9, 0, 2, 2, 0, 0, 0, 0, 0, 0, 0, 0, 0, 0, 0, 0, 0, 0, 0, 0, 0, 0, 0, 0, 2, 2, 0, 9
 9, 0, 2, 6, 1, 4, 0, 3, 4, 0, 3, 1, 1,14,14, 1, 1, 4, 0, 3, 4, 0, 3, 1, 5, 2, 0, 9
 9, 0, 6, 1, 1, 5, 0, 2, 2, 0, 2, 0, 0, 0, 0, 0, 0, 2, 0, 2, 2, 0, 6, 1, 1, 5, 0, 9
 9, 0, 0, 0, 0, 0, 0, 2, 2, 0, 2, 0, 0, 0, 0, 0, 0, 2, 0, 2, 2, 0, 0, 0, 0, 0, 0, 9
 9, 0, 3, 4, 0, 3, 1, 5, 2, 0, 2, 0, 0, 0, 0, 0, 0, 2, 0, 2, 6, 1, 4, 0, 3, 4, 0, 9
 9, 0, 2, 2, 0, 6, 1, 1, 5, 0, 6, 1, 1, 1, 1, 1, 1, 5, 0, 6, 1, 1, 5, 0, 2, 2, 0, 9
 9, 0, 2, 2, 0, 0, 0, 0, 0, 0, 0, 0, 0, 0, 0, 0, 0, 0, 0, 0, 0, 0, 0, 0, 2, 2, 0, 9
 9, 0, 2, 6, 1, 4, 0, 3, 1, 1, 1, 4, 0, 3, 4, 0, 3, 1, 1, 1, 4, 0, 3, 1, 5, 2, 0, 9
 9, 0, 6, 1, 1, 5, 0, 2, 3, 1, 1, 5, 0, 2, 2, 0, 6, 1, 1, 4, 2, 0, 6, 1, 1, 5, 0, 9
 9, 0, 0, 0, 0, 0, 0, 2, 2, 0, 0, 0, 0, 2, 2, 0, 0, 0, 0, 2, 2, 0, 0, 0, 0, 0, 0, 9
13, 8,11, 0, 3, 4, 0, 2, 2, 0, 3, 1, 1, 5, 6, 1, 1, 4, 0, 2, 2, 0, 3, 4, 0,10, 8,12
10, 8,12, 0, 2, 2, 0, 6, 5, 0, 6, 1, 1, 1, 1, 1, 1, 5, 0, 6, 5, 0, 2, 2, 0,13, 8,11
 9, 0, 0, 0, 2, 2, 0, 0, 0, 0, 0, 0, 0, 0, 0, 0, 0, 0, 0, 0, 0, 0, 2, 2, 0, 0, 0, 9
 9, 0, 3, 1, 5, 2, 0,10, 8, 8, 8,11, 0, 3, 4, 0,10, 8, 8, 8,11, 0, 2, 6, 1, 4, 0, 9
 9, 0, 6, 1, 1, 5, 0, 9,10, 8, 8,12, 0, 2, 2, 0,13, 8, 8,11, 9, 0, 6, 1, 1, 5, 0, 9
 9, 0, 0, 0, 0, 0, 0, 9, 9, 0, 0, 0, 0, 2, 2, 0, 0, 0, 0, 9, 9, 0, 0, 0, 0, 0, 0, 9
 9, 0, 3, 1, 1, 4, 0, 9, 9, 0, 3, 1, 1, 5, 6, 1, 1, 4, 0, 9, 9, 0, 3, 1, 1, 4, 0, 9
 9, 0, 6, 1, 1, 5, 0, 9, 9, 0, 6, 1, 1, 1, 1, 1, 1, 5, 0, 9, 9, 0, 6, 1, 1, 5, 0, 9
 9, 0, 0, 0, 0, 0, 0, 9, 9, 0, 0, 0, 0, 0, 0, 0, 0, 0, 0, 9, 9, 0, 0, 0, 0, 0, 0, 9
13, 8, 8, 8, 8, 8, 8,12,13, 8, 8, 8, 8, 8, 8, 8, 8, 8, 8,12,13, 8, 8, 8, 8, 8, 8,12
 0, 0, 0, 0, 0, 0, 0, 0, 0, 0, 0, 0, 0, 0, 0, 0, 0, 0, 0, 0, 0, 0, 0, 0, 0, 0, 0, 0
 0, 0, 0, 0, 0, 0, 0, 0, 0, 0, 0, 0, 0, 0, 0, 0, 0, 0, 0, 0, 0, 0, 0, 0, 0, 0, 0, 0
